yguanirae	C
verneaui	T
tilosensis	C
spinidorsum	F
silvatica_P	P
silvatica_H	H
silvatica_G	G
sanborondon	F
rugichelis	C
ramblae	G
paucispinosa	C
nesiotes	L
montanetensis	T
macra	T
longa	F
liostethus	C
levipes	T
levipes_G	G
lancerotensis	L
insulana	T
iguanensis	T
gomerensis_H	H
gomerensis_G	G
cribellata	T
calderensis_P	P
calderensis_G	G
brevispina	T
brevisetae	T
bandamae	C
arabisenen	C
alegranzaensis	L
andamanae	C
curvisetae	T
banot	T
gibbifera	T
marmoratta	T
aniepa	T
new_insulana	T
orahan	H
simbeque	L
